A=Agilent Technologies Inc.
AA=Alcoa Corp.
AAB=
AACG=ATA Creativity Global ADR
AAL=American Airlines Group Inc.
AAME=Atlantic American Corp.
AAN=Aaron's Inc.
AAOI=Applied Optoelectronics Inc.
AAON=AAON Inc.
AAP=Advance Auto Parts Inc.
AAPL=Apple Inc.
AAT=American Assets Trust Inc.
AAV=
AAWW=Atlas Air Worldwide Holdings
AAXJ=
AAXN=Axon Enterprise Inc.
AB=AllianceBernstein Holding L.P.
ABB=ABB Ltd. ADR
ABBV=AbbVie Inc.
ABC=AmerisourceBergen Corp.
ABCB=Ameris Bancorp
ABDC=Alcentra Capital Corp.
ABEO=Abeona Therapeutics Inc.
ABEV=Ambev S.A. ADR
ABG=Asbury Automotive Group Inc.
ABIL=
ABIO=ARCA biopharma Inc.
ABM=ABM Industries Inc.
ABMD=Abiomed Inc.
ABR=Arbor Realty Trust Inc.
ABT=Abbott Laboratories
ABTX=Allegiance Bancshares Inc.
ABUS=Arbutus Biopharma Corp.
ABX=
AC=Associated Capital Group Inc. Cl A
ACA=Arcosa Inc.
ACAD=ACADIA Pharmaceuticals Inc.
ACAM=Acamar Partners Acquisition Corp. Cl A
ACAMU=Acamar Partners Acquisition Corp. Un
ACAMW=Acamar Partners Acquisition Corp. Wt
ACB=Aurora Cannabis Inc.
ACBI=Atlantic Capital Bancshares Inc.
ACC=American Campus Communities Inc.
ACCO=ACCO Brands Corp.
ACD=
ACEL=Accel Entertainment Inc.
ACER=Acer Therapeutics Inc.
ACGL=Arch Capital Group Ltd.
ACGLO=Arch Capital Group Ltd. Dep. Pfd. (Rep. 1/1000th Non-Cum. Pfd. Series F)
ACGLP=Arch Capital Group Ltd. Dep. Pfd. (Rep. 1/1000th Pfd. Series E)
ACH=Aluminum Corp. of China Ltd. ADR
ACHC=Acadia Healthcare Co. Inc.
ACHN=Achillion Pharmaceuticals Inc.
ACHV=Achieve Life Sciences Inc.
ACI=
ACIA=Acacia Communications Inc.
ACIU=AC Immune S.A.
ACIW=ACI Worldwide Inc.
ACLS=Axcelis Technologies Inc.
ACM=AECOM
ACMR=ACM Research Inc. Cl A
ACN=Accenture PLC Cl A
ACNB=ACNB Corp.
ACOR=Acorda Therapeutics Inc.
ACP=
ACQ=
ACRE=Ares Commercial Real Estate Corp.
ACRS=Aclaris Therapeutics Inc.
ACRX=AcelRx Pharmaceuticals Inc.
ACST=Acasti Pharma Inc.
ACT=
ACTG=Acacia Research Corp. - Acacia Technologies
ACTT=Act II Global Acquisition Corp. Cl A
ACTTU=Act II Global Acquisition Corp.
ACTTW=Act II Global Acquisition Corp. Wt
ACV=
ACWI=
ACWX=
ACZ=
AD=
ADAP=Adaptimmune Therapeutics PLC ADR
ADBE=Adobe Inc.
ADC=Agree Realty Corp.
ADES=Advanced Emissions Solutions Inc.
ADI=Analog Devices Inc.
ADIL=ADial Pharmaceuticals Inc.
ADILW=ADial Pharmaceuticals Inc. Wt
ADM=Archer Daniels Midland Co.
ADMA=ADMA Biologics Inc.
ADMP=Adamis Pharmaceuticals Corp.
ADMS=Adamas Pharmaceuticals Inc.
ADN=
ADNT=Adient PLC
ADP=Automatic Data Processing Inc.
ADPT=Adaptive Biotechnologies Corp.
ADRA=
ADRD=
ADRE=
ADRO=Aduro Biotech Inc.
ADRU=
ADS=Alliance Data Systems Corp.
ADSK=Autodesk Inc.
ADSW=Advanced Disposal Services Inc.
ADT=ADT Inc.
ADTN=Adtran Inc.
ADUS=Addus HomeCare Corp.
ADVM=Adverum Biotechnologies Inc.
ADVZ=
ADX=
ADXS=Advaxis Inc.
AEB=AEGON N.V. 6.2996% Floating Perpetual Capital Secs.
AEE=Ameren Corp.
AEF=
AEFC=Aegon Funding Co. LLC 5.1% Sub. Notes due 2049
AEG=Aegon N.V. ADR
AEGN=Aegion Corp.
AEHR=Aehr Test Systems
AEIS=Advanced Energy Industries Inc.
AEL=American Equity Investment Life Holding Co.
AEM=Agnico Eagle Mines Ltd.
AEMD=Aethlon Medical Inc.
AEO=American Eagle Outfitters Inc.
AEP=American Electric Power Co. Inc.
AER=AerCap Holdings N.V.
AERI=Aerie Pharmaceuticals Inc.
AES=AES Corp.
AESE=Allied Esports Entertainment Inc.
AEY=ADDvantage Technologies Group Inc.
AEYE=AudioEye Inc.
AEZS=AEterna Zentaris Inc.
AFB=
AFC=Allied Capital Corp. 6.875% Notes 2047
AFG=American Financial Group Inc.
AFGB=American Financial Group Inc. 5.875% Sub. Deb. 2059
AFGC=American Financial Group Inc. 5.125% Sub. Deb. due 2059
AFGH=American Financial Group Inc. 6% Sub. Deb. 2055
AFH=Atlas Financial Holdings Inc.
AFI=Armstrong Flooring Inc.
AFIN=American Finance Trust Inc. Cl A
AFINP=American Finance Trust Inc. 7.5% Pfd. Series A
AFL=AFLAC Inc.
AFMD=Affimed N.V.
AFN=
AFT=
AFYA=Afya Ltd.
AG=First Majestic Silver Corp.
AGBAR=AGBA Acquisition Ltd. Rt
AGBAU=AGBA Acquisition Ltd. Un
AGBAW=AGBA Acquisition Ltd. Wt
AGCO=AGCO Corp.
AGD=
AGEN=Agenus Inc.
AGFS=AgroFresh Solutions Inc.
AGFSW=AgroFresh Solutions Inc. Wt
AGI=Alamos Gold Inc.
AGIO=Agios Pharmaceuticals Inc.
AGLE=Aeglea BioTherapeutics Inc.
AGM=Federal Agricultural Mortgage Corp. Cl C
AGMH=AGM Group Holdings Inc.
AGN=Allergan PLC
AGNC=AGNC Investment Corp.
AGNCM=AGNC Investment Corp. Dep. Pfd. (Rep. 6.875% Cum. Redeem. Pfd. Series D
AGNCN=AGNC Investment Corp. Dep. Pfd. (Rep. 1/1000th Pfd. Series C)
AGNCO=AGNC Investment Corp. Dep. Pfd. (Rep. 1/1000th 6.5% Pfd. Series E)
AGND=
AGO=Assured Guaranty Ltd.
AGR=Avangrid Inc.
AGRO=Adecoagro S.A.
AGRX=Agile Therapeutics Inc.
AGS=PlayAGS Inc.
AGTC=Applied Genetic Technologies Corp.
AGX=Argan Inc.
AGYS=Agilysys Inc.
AGZD=
AHC=A. H. Belo Corp. Series A
AHCO=AdaptHealth Corp. Cl A
AHH=Armada Hoffler Properties Inc.
AHPI=Allied Healthcare Products Inc.
AHT=Ashford Hospitality Trust Inc.
AI=Arlington Asset Investment Corp. Cl A
AIA=
AIC=Arlington Asset Investment Corp. 6.75% Sr. Notes 031525
AIF=
AIG=American International Group Inc.
AIH=Aesthetic Medical International Holdings Group Ltd. ADR
AIHS=Senmiao Technology Ltd.
AII=
AIM=AIM ImmunoTech Inc.
AIMC=Altra Industrial Motion Corp.
AIMT=Aimmune Therapeutics Inc.
AIN=Albany International Corp. Cl A
AINV=
AIO=
AIQ=
AIR=AAR Corp.
AIRG=Airgain Inc.
AIRR=
AIRT=Air T Inc.
AIRTP=Air T Inc. Pfd.
AIRTW=Air T Inc. Wt
AIT=Applied Industrial Technologies Inc.
AIV=Apartment Investment & Management Co.
AIW=Arlington Asset Investment Corp. 6.625% Notes due 2023
AIZ=Assurant Inc.
AIZP=Assurant Inc. 6.5% Cum. Redeem. Pfd. Series D
AJG=Arthur J. Gallagher & Co.
AJRD=Aerojet Rocketdyne Holdings Inc.
AJX=Great Ajax Corp.
AJXA=Great Ajax Corp. 7.25% Conv. Sr. Notes due 2024
AKAM=Akamai Technologies Inc.
AKBA=Akebia Therapeutics Inc.
AKCA=Akcea Therapeutics Inc.
AKER=Akers Biosciences Inc.
AKG=Asanko Gold Inc.
AKR=Acadia Realty Trust
AKRO=Akero Therapeutics Inc.
AKRX=Akorn Inc.
AKS=AK Steel Holding Corp.
AKTS=Akoustis Technologies Inc.
AKTX=Akari Therapeutics PLC ADR
AKU=
AL=Air Lease Corp.
ALA=
ALAC=Alberton Acquisition Corp. Cl A
ALACR=Alberton Acquisition Corp. Rt
ALACU=Alberton Acquisition Corp. Un
ALACW=Alberton Acquisition Corp. Wt
ALB=Albemarle Corp.
ALBO=Albireo Pharma Inc.
ALC=Alcon Inc.
ALCO=Alico Inc.
ALDX=Aldeyra Therapeutics Inc.
ALE=Allete Inc.
ALEC=Alector Inc.
ALEF=
ALEX=Alexander & Baldwin Inc.
ALG=Alamo Group Inc.
ALGN=Align Technology Inc.
ALGR=Allegro Merger Corp.
ALGRR=Allegro Merger Corp. Rt
ALGRU=Allegro Merger Corp. Un
ALGRW=Allegro Merger Corp. Wt
ALGT=Allegiant Travel Co.
ALIM=Alimera Sciences Inc.
ALJJ=ALJ Regional Holdings Inc.
ALK=Alaska Air Group Inc.
ALKS=Alkermes PLC
ALL=Allstate Corp.
ALLE=Allegion PLC
ALLK=Allakos Inc.
ALLO=Allogene Therapeutics Inc.
ALLT=Allot Ltd.
ALLY=Ally Financial Inc.
ALNA=Allena Pharmaceuticals Inc.
ALNY=Alnylam Pharmaceuticals Inc.
ALO=Alio Gold Inc.
ALOT=AstroNova Inc.
ALPN=Alpine Immune Sciences Inc.
ALRM=Alarm.Com Holdings Inc.
ALRN=Aileron Therapeutics Inc.
ALRS=Alerus Financial Corp.
ALS=
ALSK=Alaska Communications Systems Group Inc.
ALSN=Allison Transmission Holdings Inc.
ALT=Altimmune Inc.
ALTM=Altus Midstream Co.
ALTR=Altair Engineering Inc. Cl A
ALTY=
ALUS=Alussa Energy Acquisition Corp. Cl A
ALV=Autoliv Inc.
ALX=Alexander's Inc.
ALXN=Alexion Pharmaceuticals Inc.
ALYA=Alithya Group Inc. Cl A
AM=Antero Midstream Corp.
AMAG=AMAG Pharmaceuticals Inc.
AMAL=Amalgamated Bank Cl A
AMAT=Applied Materials Inc.
AMBA=Ambarella Inc.
AMBC=Ambac Financial Group Inc.
AMBCW=Ambac Financial Group Inc. Wt
AMC=AMC Entertainment Holding Inc. Cl A
AMCA=
AMCI=AMCI Acquisition Corp. Cl A
AMCIU=AMCI Acquisition Corp. Un
AMCIW=AMCI Acquisition Corp. Wt
AMCR=Amcor PLC
AMCX=AMC Networks Inc. Cl A
AMD=Advanced Micro Devices Inc.
AME=Ametek Inc.
AMED=Amedisys Inc.
AMEH=Apollo Medical Holdings Inc.
AMG=Affiliated Managers Group Inc.
AMGN=Amgen Inc.
AMH=American Homes 4 Rent Cl A
AMHC=Amplitude Healthcare Acquisition Corp. Cl A
AMHCU=Amplitude Healthcare Acquisition Corp.
AMHCW=Amplitude Healthcare Acquisition Corp. Wt
AMK=AssetMark Financial Holdings Inc.
AMKR=Amkor Technology Inc.
AMM=
AMN=AMN Healthcare Services Inc.
AMNB=American National Bankshares Inc.
AMOT=Allied Motion Technologies Inc.
AMOV=America Movil S.A.B. de C.V. ADR
AMP=Ameriprise Financial Inc.
AMPH=Amphastar Pharmaceuticals Inc.
AMPY=Amplify Energy Corp.
AMRB=American River Bankshares
AMRC=Ameresco Inc. Cl A
AMRH=Ameri Holdings Inc.
AMRHW=Ameri Holdings Inc. Wt
AMRK=A-Mark Precious Metals Inc.
AMRN=Amarin Corp. PLC ADR
AMRS=Amyris Inc.
AMRX=Amneal Pharmaceuticals Inc.
AMSC=American Superconductor Corp.
AMSF=AMERISAFE Inc.
AMSWA=American Software Inc. Cl A
AMT=American Tower REIT
AMTB=Amerant Bancorp Inc. Cl A
AMTBB=Amerant Bancorp Inc. Cl B
AMTD=TD Ameritrade Holding Corp.
AMTX=Aemetis Inc.
AMWD=American Woodmark Corp.
AMX=America Movil S.A.B. de C.V. ADR Series L
AMZN=Amazon.com Inc.
AN=AutoNation Inc.
ANAB=AnaptysBio Inc.
ANAT=American National Insurance Co.
ANCN=Anchiano Therapeutics Ltd. ADR
AND=
ANDA=Andina Acquisition Corp. III
ANDAR=Andina Acquisition Corp. III Rt
ANDAU=Andina Acquisition Corp. III
ANDAW=Andina Acquisition Corp. III Wt
ANDE=Andersons Inc.
ANET=Arista Networks Inc.
ANF=Abercrombie & Fitch Co.
ANGI=ANGI Homeservices Inc. Cl A
ANGL=
ANGO=AngioDynamics Inc.
ANH=Anworth Mortgage Asset Corp.
ANIK=Anika Therapeutics Inc.
ANIP=ANI Pharmaceuticals Inc.
ANIX=Anixa Biosciences Inc.
ANSS=Ansys Inc.
ANTE=AirNet Technology Inc. ADR
ANTM=Anthem Inc.
ANX=
ANY=Sphere 3D Corp.
AOBC=American Outdoor Brands Corp.
AOD=
AOI=
AON=Aon PLC
AOS=A.O. Smith Corp.
AOSL=Alpha & Omega Semiconductor Inc.
AOT=
AP=Ampco-Pittsburgh Corp.
APA=Apache Corp.
APAM=Artisan Partners Asset Management Inc.
APD=Air Products & Chemicals Inc.
APDN=Applied DNA Sciences Inc.
APEI=American Public Education Inc.
APEN=Apollo Endosurgery Inc.
APEX=Apex Global Brands Inc.
APH=Amphenol Corp. Cl A
APHA=Aphria Inc.
APLE=Apple Hospitality REIT Inc.
APLS=Apellis Pharmaceuticals Inc.
APLT=Applied Therapeutics Inc.
APM=Aptorum Group Ltd.
APO=Apollo Global Management Inc. Cl A
APOG=Apogee Enterprises Inc.
APOP=Cellect Biotechnology Ltd. ADR
APOPW=Cellect Biotechnology Ltd. Wt
APPF=AppFolio Inc.
APPN=Appian Corp. Cl A
APPS=Digital Turbine Inc.
APRE=Aprea Therapeutics Inc.
APRN=Blue Apron Holdings Inc.
APS=
APTO=Aptose Biosciences Inc.
APTS=Preferred Apartment Communities Inc.
APTV=Aptiv PLC
APTX=Aptinyx Inc.
APVO=Aptevo Therapeutics Inc.
APWC=Asia Pacific Wire & Cable Corp.
APXT=Apex Technology Acquisition Corp. Cl A
APXTU=Apex Technology Acquisition Corp.
APXTW=Apex Technology Acquisition Corp. Wt
APY=Apergy Corp.
APYX=Apyx Medical Corp.
AQA=
AQB=AquaBounty Technologies Inc.
AQMS=Aqua Metals Inc.
AQN=Algonquin Power & Utilities Corp.
AQNA=Algonquin Power & Utilities Corp. 6.875% Fixed-to-Floating Rate Sub. Notes Series 2018-A due October 17, 2078
AQNB=Algonquin Power & Utilities Corp. 6.2% Fixed-to-Floating Sub. Notes 070179
AQST=Aquestive Therapeutics Inc.
AQUA=Evoqua Water Technologies Corp.
AR=Antero Resources Corp.
ARA=American Renal Associates Holdings Inc.
ARAV=Aravive Inc.
ARAY=Accuray Inc.
ARC=ARC Document Solutions Inc.
ARCB=ArcBest Corp.
ARCC=Ares Capital Corp.
ARCE=Arco Platform Ltd. Cl A
ARCH=Arch Coal Inc.
ARCO=Arcos Dorados Holdings Inc. Cl A
ARCT=Arcturus Therapeutics Holdings Inc.
ARD=Ardagh Group S.A. Cl A
ARDC=
ARDS=Aridis Pharmaceuticals Inc.
ARDX=Ardelyx Inc.
ARE=Alexandria Real Estate Equities Inc.
AREC=American Resources Corp.
ARES=Ares Management Corp.
ARG=
ARGD=Argo Group International Holdings Ltd. 6.5% Sr. Notes Due 2042
ARGO=Argo Group International Holdings Ltd.
ARGX=arGEN-X SE ADR
ARI=Apollo Commercial Real Estate Finance Inc.
ARKR=ARK Restaurants Corp.
ARL=American Realty Investors Inc.
ARLO=Arlo Technologies Inc.
ARLP=Alliance Resource Partners L.P.
ARMK=Aramark
ARNA=Arena Pharmaceuticals Inc.
ARNC=Arconic Inc.
AROC=Archrock Inc.
AROW=Arrow Financial Corp.
ARPO=Aerpio Pharmaceuticals Inc.
ARQL=
ARR=Armour Residential REIT Inc.
ARTL=Artelo Biosciences Inc.
ARTLW=Artelo Biosciences Inc. Wt
ARTNA=Artesian Resources Corp. Cl A
ARTW=Art's Way Manufacturing Co.
ARVN=Arvinas Inc.
ARW=Arrow Electronics Inc.
ARWR=Arrowhead Pharmaceuticals Corp.
ARX=
ARYA=ARYA Sciences Acquisition Corp.
ARYAU=ARYA Sciences Acquisiton Corp. Un
ARYAW=ARYA Sciences Acquisiton Corp. Wt
ASA=
ASB=Associated Banc-Corp.
ASC=Ardmore Shipping Corp.
ASET=
ASFI=Asta Funding Inc.
ASG=
ASGN=ASGN Inc.
ASH=Ashland Global Holdings Inc.
ASIX=AdvanSix Inc.
ASLN=Aslan Pharmaceuticals Ltd. ADR
ASM=Avino Silver & Gold Mines Ltd.
ASMB=Assembly Biosciences Inc.
ASML=ASML Holding N.V.
ASNA=Ascena Retail Group Inc.
ASND=Ascendis Pharma A/S ADR
ASO=
ASP=
ASPN=Aspen Aerogels Inc.
ASPS=Altisource Portfolio Solutions S.A.
ASPU=Aspen Group Inc.
ASR=Grupo Aeroportuario del Sureste S.A.B. de C.V. ADR
ASRT=Assertio Therapeutics Inc.
ASRV=AmeriServ Financial Inc.
ASRVP=AmeriServ Financial Inc. Pfd.
ASTC=Astrotech Corp.
ASTE=Astec Industries Inc.
ASUR=Asure Software Inc.
ASX=ASE Technology Holding Co. Ltd. ADR
ASYS=Amtech Systems Inc.
AT=Atlantic Power Corp.
ATA=
ATAX=America First Multifamily Investors L.P.
ATEC=Alphatec Holdings Inc.
ATEN=A10 Networks Inc.
ATEX=Anterix Inc.
ATGE=Adtalem Global Education Inc.
ATH=Athene Holding Ltd.
ATHE=Alterity Therapeutics Ltd. ADR
ATHM=Autohome Inc. ADR
ATHX=Athersys Inc.
ATI=Allegheny Technologies Inc.
ATIF=ATIF Holdings Ltd.
ATKR=Atkore International Group Inc.
ATLC=Atlanticus Holdings Corp.
ATLO=Ames National Corp.
ATNI=ATN International Inc.
ATNX=Athenex Inc.
ATO=Atmos Energy Corp.
ATOM=Atomera Inc.
ATOS=Atossa Genetics Inc.
ATP=
ATR=Aptargroup Inc.
ATRA=Atara Biotherapeutics Inc.
ATRC=AtriCure Inc.
ATRI=Atrion Corp.
ATRO=Astronics Corp.
ATRS=Antares Pharma Inc.
ATSG=Air Transport Services Group Inc.
ATTO=Atento S.A.
ATUS=Altice USA Inc. Cl A
ATV=Acorn International Inc. ADR
ATVI=Activision Blizzard Inc.
ATXI=Avenue Therapeutics Inc.
ATZ=
AU=AngloGold Ashanti Ltd. ADR
AUB=Atlantic Union Bankshares Corp.
AUBN=Auburn National Bancorp
AUDC=AudioCodes Ltd.
AUG=Auryn Resources Inc.
AUMN=Golden Minerals Co.
AUP=
AUPH=Aurinia Pharmaceuticals Inc.
AUTL=Autolus Therapeutics Ltd. ADR
AUTO=AutoWeb Inc.
AUY=Yamana Gold Inc.
AVA=Avista Corp.
AVAL=Grupo Aval Acciones y Valores S.A. ADR
AVAV=AeroVironment Inc.
AVB=Avalonbay Communities Inc.
AVCN=
AVCO=Avalon GloboCare Corp.
AVD=American Vanguard Corp.
AVDL=Avadel Pharmaceuticals PLC ADR
AVEO=AVEO Pharmaceuticals Inc.
AVGO=Broadcom Inc.
AVGOP=Broadcom Inc. 8% Pfd. Series A
AVGR=Avinger Inc.
AVH=Avianca Holdings S.A. ADR
AVID=Avid Technology Inc.
AVK=
AVL=
AVLR=Avalara Inc.
AVNS=Avanos Medical Inc.
AVNW=Aviat Networks Inc.
AVP=
AVRO=AVROBIO Inc.
AVT=Avnet Inc.
AVTR=Avantor Inc.
AVX=AVX Corp.
AVXL=Anavex Life Sciences Corp.
AVY=Avery Dennison Corp.
AVYA=Avaya Holdings Corp.
AWF=
AWI=Armstrong World Industries Inc.
AWK=American Water Works Co.
AWP=
AWR=American States Water Co.
AWRE=Aware Inc.
AX=Axos Financial Inc.
AXAS=Abraxas Petroleum Corp.
AXDX=Accelerate Diagnostics Inc.
AXE=Anixter International Inc.
AXGN=Axogen Inc.
AXGT=Axovant Gene Therapies Ltd.
AXL=American Axle & Manufacturing Holdings Inc.
AXLA=Axcella Health Inc.
AXNX=Axonics Modulation Technologies Inc.
AXO=Axos Financial Inc. 6.25% Sub. Notes 2026
AXP=American Express Co.
AXR=Amrep Corp.
AXS=AXIS Capital Holdings Ltd.
AXSM=Axsome Therapeutics Inc.
AXTA=Axalta Coating Systems Ltd.
AXTI=AXT Inc.
AXU=Alexco Resource Corp.
AY=Atlantica Yield PLC
AYI=Acuity Brands Inc.
AYM=
AYR=Aircastle Ltd.
AYTU=Aytu BioScience Inc.
AYX=Alteryx Inc. Cl A
AZN=AstraZeneca PLC ADR
AZO=AutoZone Inc.
AZPN=Aspen Technology Inc.
AZRE=Azure Power Global Ltd.
AZRXAZUL=
AZZB=
BA=Boeing Co.
BABA=Alibaba Group Holding Ltd. ADR
BAC=Bank of America Corp.
BAD=
BAF=
BAH=Booz Allen Hamilton Holding Corp.
BAK=Braskem S/A ADR
BAM=Brookfield Asset Management Inc. Cl A
BANC=Banc of California Inc.
BAND=Bandwidth Inc. Cl A
BANF=BancFirst Corp.
BANFP=BFC Capital Trust II 7.2% Cum. Trust Pfd. Secs
BANR=Banner Corp.
BANX=
BAP=Credicorp Ltd.
BAR=
BASE=
BASI=Bioanalytical Systems Inc.
BATRA=Liberty Media Corp. Series A Liberty Braves
BATRK=Liberty Media Corp. Series C Liberty Braves
BAX=Baxter International Inc.
BB=BlackBerry Ltd.
BBAR=Banco BBVA Argentina S.A. ADR
BBBY=Bed Bath & Beyond Inc.
BBCP=Concrete Pumping Holdings Inc.
BBD=Banco Bradesco S/A Pref ADR
BBDC=Barings BDC Inc.
BBDO=Banco Bradesco S/A Ord ADR
BBF=
BBGI=Beasley Broadcast Group Inc. Cl A
BBH=
BBI=Brickell Biotech Inc.
BBIO=BridgeBio Pharma Inc.
BBK=
BBL=BHP Group PLC ADR
BBN=
BBQ=BBQ Holdings Inc.
BBSI=Barrett Business Services Inc.
BBU=Brookfield Business Partners L.P.
BBVA=Banco Bilbao Vizcaya Argentaria S.A. ADR
BBW=Build-A-Bear Workshop Inc.
BBX=BBX Capital Corp. Cl A
BBY=Best Buy Co. Inc.
BC=Brunswick Corp.
BCB=
BCBP=BCB Bancorp Inc.
BCC=Boise Cascade Co.
BCDA=BioCardia Inc.
BCDAW=BioCardia Inc. Wt
BCE=BCE Inc.
BCEI=Bonanza Creek Energy Inc.
BCEL=Atreca Inc. Cl A
BCH=Banco de Chile ADR
BCI=
BCLI=Brainstorm Cell Therapeutics Inc.
BCML=BayCom Corp.
BCO=Brink's Co.
BCOM=B Communications Ltd.
BCOR=Blucora Inc.
BCOV=Brightcove Inc.
BCOW=1895 Bancorp of Wisconsin Inc.
BCPC=Balchem Corp.
BCRH=Blue Capital Reinsurance Holdings Ltd.
BCRX=BioCryst Pharmaceuticals Inc.
BCS=Barclays PLC ADR
BCSF=Bain Capital Specialty Finance Inc.
BCTF=Bancorp 34 Inc.
BCX=
BCYC=Bicycle Therapeutics Ltd. ADR
BDC=Belden Inc.
BDGE=Bridge Bancorp Inc.
BDI=
BDIV=
BDJ=
BDN=Brandywine Realty Trust
BDSI=BioDelivery Sciences International Inc.
BDT=
BDX=Becton Dickinson & Co.
BDXA=Becton Dickinson & Co. Dep. Pfd. (Rep. 1/20th Mand. Conv. Pfd. Series A)
BE=Bloom Energy Corp.
BEAT=BioTelemetry Inc.
BECN=Beacon Roofing Supply Inc.
BEDU=Bright Scholar Education Holdings Ltd. ADR
BELFA=Bel Fuse Inc. Cl A
BELFB=Bel Fuse Inc. Cl B
BEN=Franklin Resources Inc.
BEP=Brookfield Renewable Partners L.P.
BERY=Berry Global Group Inc.
BEST=BEST Inc. ADR
BFAM=Bright Horizons Family Solutions Inc.
BFC=Bank First Corp.
BFIN=BankFinancial Corp.
BFIT=
BFK=
BFO=
BFRA=Biofrontera AG ADR
BFS=Saul Centers Inc.
BFST=Business First Bancshares Inc.
BFY=
BFZ=
BG=Bunge Ltd.
BGB=
BGC=
BGCP=BGC Partners Inc. Cl A
BGFV=Big 5 Sporting Goods Corp.
BGG=Briggs & Stratton Corp.
BGH=
BGIO=
BGNE=BeiGene Ltd. ADR
BGR=
BGRN=
BGS=B&G Foods Inc.
BGSF=BG Staffing Inc.
BGT=
BGU=
BGX=
BGY=
BH=Biglari Holdings Inc. Cl B
BHAT=Blue Hat Interactive Entertainment Technology
BHC=Bausch Health Cos. Inc.
BHE=Benchmark Electronics Inc.
BHF=Brighthouse Financial Inc.
BHFAL=Brighthouse Financial Inc. 6.25% Jr. Sub. Deb. 2058
BHFAP=Brighthouse Financial Inc. Dep. Pfd. (Rep. 1/1000th Share Pfd. Series A)
BHK=
BHLB=Berkshire Hills Bancorp Inc.
BHP=BHP Group Ltd. ADR
BHR=Braemar Hotels & Resorts Inc.
BHTG=BioHiTech Global Inc.
BHV=
BHVN=Biohaven Pharmaceutical Holding Co. Ltd.
BIB=
BICK=
BIDU=Baidu Inc. ADR
BIF=
BIG=Big Lots Inc.
BIIB=Biogen Inc.
BILI=Bilibili Inc. ADR
BILL=Bill.com Holdings Inc.
BIMI=BOQI International Medical Inc.
BIO=Bio-Rad Laboratories Inc. Cl A
BIOC=Biocept Inc.
BIOL=Biolase Inc.
BIOS=Option Care Health Inc.
BIP=Brookfield Infrastructure Partners L.P.
BIR=
BIS=
BIT=
BITA=Bitauto Holdings Ltd. ADR
BJ=BJ's Wholesale Club Holdings Inc.
BJK=
BJRI=BJ's Restaurants Inc.
BK=Bank of New York Mellon Corp.
BKCC=BlackRock Capital Investment Corp.
BKCH=
BKD=Brookdale Senior Living Inc.
BKE=Buckle Inc.
BKEP=Blueknight Energy Partners G.P. LLC
BKEPP=Blueknight Energy Partners L.P. LLC Pfd. Series A
BKH=Black Hills Corp.
BKI=Black Knight Inc.
BKK=
BKN=
BKNG=Booking Holdings Inc.
BKR=Baker Hughes Co.
BKSC=Bank of South Carolina Corp.
BKT=
BKU=BankUnited Inc.
BKX=
BKYI=BIO-key International Inc.
BL=BlackLine Inc.
BLBD=Blue Bird Corp.
BLCK=Blackcraft Cult Inc.
BLCM=Bellicum Pharmaceuticals Inc.
BLCN=
BLD=TopBuild Corp.
BLDP=Ballard Power Systems Inc.
BLDR=Builders FirstSource Inc.
BLE=
BLFS=BioLife Solutions Inc.
BLIN=Bridgeline Digital Inc.
BLK=BlackRock Inc.
BLKB=Blackbaud Inc.
BLL=Ball Corp.
BLMN=Bloomin' Brands Inc.
BLNK=Blink Charging Co.
BLNKW=Blink Charging Co. Wt
BLPH=Bellerophon Therapeutics Inc.
BLRX=BioLine RX Ltd. ADR
BLU=BELLUS Health Inc.
BLUE=bluebird bio Inc.
BLW=
BLX=Banco Latinoamericano de Comercio Exterior S.A. Cl E
BMA=Banco Macro S.A. ADR
BMCH=BMC Stock Holdings Inc.
BME=
BMI=Badger Meter Inc.
BMLP=
BMO=Bank of Montreal
BMRA=Biomerica Inc.
BMRC=Bank of Marin Bancorp
BMRN=BioMarin Pharmaceutical Inc.
BMTC=Bryn Mawr Bank Corp.
BMY=Bristol-Myers Squibb Co.
BNC=
BND=
BNDW=
BNDX=
BNE=
BNED=Barnes & Noble Education Inc.
BNFT=Benefitfocus Inc.
BNG=
BNGO=Bionano Genomics Inc.
BNGOW=Bionano Genomics Inc. Wt
BNP=
BNS=Bank of Nova Scotia
BNSO=Bonso Electronics International Inc.
BNTC=Benitec Biopharma Ltd. ADR
BNTCW=Benitec Biopharma Ltd. Wt
BNTX=BioNTech SE ADR
BNY=
BOCH=Bank of Commerce Holdings
BOE=
BOH=Bank of Hawaii Corp.
BOKF=BOK Financial Corp.
BOKFL=BOK Financial Corp. 5.375% Sub. Notes 2056
